SSSUUUUOUUUUUOUUUUUU
SSSUUUUUUUUUUOUUUUUU
SSSUUUUUUUUUUOUUUUUU
UUUUUUUUUUUUUOUUUUUU
UUUUUUUUUUUUUOUUUUUU
UUUUUUUUOUUUUOUUUUUU
UUUUUUUUOUUUUUUUUUUU
OUUUUUUUOUUUUUUUUUOO
UUUUUUUUOUUUUUUUUUUU
UUUUUUUUOUUUUUUUUUUU
UUUUUUUUOUUUUUUUUUUU
UUUOUUUUUUUUUUOUUUUU
UUUOUUUUUUUUUUOUUEEE
UUUOUUUUUUUUUUOUUEEE
UUUOUUUUUUUUUUOUUEEE
