SSSUUUUUUOOOUUUUUUUU
SSSUUUUUUUUOUUUUUUUU
SSSUUUUUUUUOUUUUUUUU
UUUUUUUUUUUOUUUOOUUU
UUUUUOUUUUUUUUUUUUUU
UUUUUOUUUUUUUUUUUUUU
UUUUOOUUUUUUUUUUUUUU
UUUUUUUUUUUUUUUUUOOO
UUUUUUUUUUUUUUUUUUUO
UUUUUUUUUUUUUUUUUUUU
OOOUUUUUUUOOOUUUUUUU
UUUUUUUUUUOOUUUUUUUU
UUUUUUOUUUUUUUUUUEEE
UUUUUUOUUUUUUUUUUEEE
UUUUUOOUUUUUUUUOUEEE
