SSSUUUUUUUUUUUUUUUUU
SSSUUUUUUUUUUUUUUUUU
SSSUUUUUUUUUUUUUUUUU
UUUUOUUUUOOOOOOUUUUU
UUUUOUUUUUUUUUUUUUOO
OUUUOUUUUUUUUUUUUUUU
OUUUUUUUUUUUUUUUUUUU
OUUUUUUUUUUUUUUUUUUU
UUUUUUUUUUUUUUUUUUUU
UUUUUUUUUUUUUUUOUUUO
UUUUUUUUUUUUUUUOUUUU
UUUUUOOOOOOUUUUOUUUU
UUUUUUUUUUUUUUUUUEEE
UUUUUUUUUUUUUUUUUEEE
UUUUUUUUUUUUUUUUUEEE
