SSSUUUUUUUOUUUUOOUUU
SSSUUUUUUUOUUUUOUUUU
SSSUUUUUUUOUUUUOUUUU
UUUUUUUUUUOOUUUOUUUU
UUUUUOUUUUUUUUUUUUUU
UUUUUOUUUUUUUUUUUUUU
UUUUUOUUUUUUUUUUUUUU
UUUUUOUUUUUUUUOOUUUO
UUUUUOUUUUUUUUOUUUUU
UUUUUOUUUUUUOOOUUUUU
UUUUUUUUUUUUUUUUUUUU
UUUUUUUUUUUUUUUUUUUU
UUUUUUUUUUUUUUUUUEEE
UUUUUOUUUUUUUUUUUEEE
UUUUUOOOOUUUUOOUUEEE