SSSUUUOUUUUUOUUUUUUU
SSSUUUOUUUUUOUUUUUUU
SSSUUUOOUUUUOOUUUUUU
UUUUUUUUUUUUUUUUUOOO
UUUUUUUUUUUUUUUUUUUU
UUUUUUUUUUUUUUUUUUUU
UUUUUUUUUOOOOUUUUUUU
UUUUUUOUUUUUOUUUUUUU
UUUUUUOUUUUUUUUOOUUU
UUOUUUOUUUUUUUUOOUUU
UUOUUUUUUUUUUUUUUUUU
UUOUUUUUUUUOUUUUUUUU
UUUUUUUUUUUOUUUUUEEE
UUUUUUUUUUUOUUUUUEEE
UUUUUUUUUUUOUUUUUEEE