SSSUUUUUUOUUUUUOUUUU
SSSUUUUUUOUUUUUOUUUU
SSSUUUUUUOUUUUUOUUUU
UUUUUUUUUOOUUUOOUUUU
UUUUUOUUUUUUUUUUUUUU
UUUUOOUUUUUUUUUUUUUU
UUUUOOUUUUUUUUUUUUUU
UUUUOUUUUUUUUUUUUUUO
UUUUUUUUUUUUUOOUUUUU
UUUUUUUUUUUUUOUUUUUU
UUUUUUUUUUUOOOUUUUUU
UUUUUUUUUUUUUUUUUUUU
UUUUUUUUUUUUUUUUUEEE
UUUOUUUUUUUUUUUUUEEE
UUUOOOOUUUUUOOUUUEEE








