SSSUUUUUUUOUUUUOUUUU
SSSUUUUUUUOUUUUOUUUU
SSSUUUUUUUOUUUUOUUUU
UUUUUUUUUUOOUUUOOUUU
UUUUUUOUUUUUUUUUUUUU
UUUUUUOUUUUUUUUUUUUU
UUUUUUOUUUUUUUUUUUUU
OUUUUUOUUUUUUUUOUUUU
OUUUUUOUUUUUUUOUUUUO
OUUUUUOUUUUUUOUUUUUU
UUUUUUUUUUOOOUUUUUUU
UUUUUUUUUUUUUUUUUUUU
UUUUUUUUUUUUUUUUUEEE
UUUUUUUUUUUUUUUUUEEE
UUUUUOOOUUUUUUOUUEEE
