SSSUUUUUUOOOUUUUUUUU
SSSUUUUUUUUOUUUUUUUU
SSSUUUUUUUUOUUUUUUUU
UUUUUOUUUUUOUUUOOUUU
UUUUUOUUUUUUUUUUUUUU
UUUUUOUUUUUUUUUUUUUU
UUUUOOUUUUUUUUUUUUUU
UUUUUUUUUUUUUUUUUOOO
UUUUUUUUUUUUUUUUUUUO
UUUUUUUUUUUUUUUUUUUU
UUUUUUUUUUUOOOUUUUUU
OOOUUUUUUUOOUUUUUUUU
UUUUUUOUUUUUUUUUUEEE
UUUUUUOUUUUUUUUUUEEE
UUUUUUOUUUUUUUOOUEEE