SSSUUUOUUUUUOUUUUUUU
SSSUUUOUUUUUOUUUUUUU
SSSUUUOOUUUUOOUUUUUU
UUUUUUUUUUUUUUUUUOOO
UUUUUUUUUUUUUUUUUUUU
UUUUUUUUUUUUUUUUUUUU
UUUUUUUUUOOOOUUUUUUU
UUUUOUUUUUUUOUUUUUUU
UUUUOUUUUUUUUUUOOUUU
UUUOOUUUUUUUUUUOUUUU
UUUOUUUUUUUUUUUUUUUU
UUUOUUUUUUUOUUUUUUUU
UUUUUUUUUUUOUUUUUEEE
UUUUUUUUUUUOUUUUUEEE
UUUUUUUUUUUOUUUOUEEE