SSSUUUUUUOOOUUUUUUUU
SSSUUUUUUUUOUUUUUUUU
SSSUUUUUUUUOUUUUUUUU
UUUUUUUUUUUUUUUOUUUU
UUUUOUUUUUUUUUUOUUUU
UUUUOUUUUUUUUUUUUUUU
UUUOOUUUUUUUUUUUUUUU
UUUUUUUUUUUUUUUUUOOO
UUUUUUUUUUUUUUUUUUUU
UUUUUUUUUUOOUUUUUUUU
OOOUUUUUUUUUOOOUUUUU
OOOUUUUUUUUUUUUUUUUU
UUUUUUOUUUUUUUUUUEEE
UUUUUUOUUUUUUUUUUEEE
UUUUUUOUUUUUUOOUUEEE