SSSUUUUUUUOUUUUOUUUU
SSSUUUUUUUOUUUUOUUUU
SSSUUUUUUUOUUUUOUUUU
UUUUUUUUUUOOUUUOOUUU
UUUUUUOUUUUUUUUUUUUU
UUUUUUOUUUUUUUUUUUUU
UUUUUUOUUUUUUUUUUUUU
OOOUUUOUUUUUUUUOUUUU
UUUUUUOUUUUUUUOUUUUO
UUUUUUOUUUUUUOUUUUUU
UUUUUUUUUUOOOUUUUUUU
UUUUUUUUUUUUUUUUUUUU
UUUUUUUUUUUUUUUUUEEE
UUUUUUUUUUUUUUUUUEEE
UUUUUOOOUUUUUUOUUEEE
