SSSUUUUUUOOOUUUUUUUU
SSSUUUUUUUUOUUUUUUUU
SSSUUUUUUUUOUUUUUUUU
UUUUUOUUUUUOUUUOOUUU
UUUUOOUUUUUUUUUUUUUU
UUUUUOUUUUUUUUUUUUUU
UUUUUUUUUUUUUUUUUUUU
UUUUUUUUUUUUUUUUUOOO
UUUUUUUUUUUUUUUUUUUO
UUUUUUUUUUUUUUUUUUUU
OOOUUUUUUUUUOOUUUUUU
OOOUUUUUUUOOUUUUUUUU
UUUUUUOUUUUUUUUUUEEE
UUUUUUOUUUUUUUUUUEEE
UUUUUUOUUUUUUUUOUEEE