SSSUUUOUUUUUOUUUUUUU
SSSUUUOUUUUUOUUUUUUU
SSSUUUOUUUUUOUUUUUUU
UUUUUUOUUUUUOUUUUUUU
UUUUUUOUUUUUUUUUUUUU
UUUUUUOUUUUUUUUUUOOO
UUUUUUUUUUUUUUUUUUUU
UUUUUUUUUUUUUUUUUUUU
UUUUUUUUUUUOUUUUUUUU
OOOUUUUUUUOUUUUUUUUU
UUUUUUUUUOUUUUUUUUUU
UUUUUUUUUUUUUUUUUUUU
UUUUUUUUUUUUUUOUUEEE
UUUUUUUUUUUUUUOUUEEE
UUUUUUUUUUUUUUOUUEEE
