SSSUUUUUUUOUUUUOUUUU
SSSUUUUUUUOUUUUOUUUU
SSSUUUUUUUOUUUUOUUUU
UUUUUUUUUUOOUUUOOUUU
UUUUUUUUUUUUUUUUUUUU
UUUOUUUUUUUUUUUUUUUU
UUUOUUUUUUUUUUUUUUUU
UUUOUUUUUUUUUUUOUUUU
UUUOUUUUUUUUUUOUUUUU
UUUOUUUUUUUUUOUUUUUU
UUUOUUUUUOOOOUUUUUUU
UUUUUUUUUUUUUUUUUUUU
UUUUUUUUUUUUUUUUUEEE
UUUUUUUUUUUUUUUUUEEE
UUUUUOOOUUUUOOOUUEEE
