SSSUUUUOUUUUUUUUUUUU
SSSUUUUOUUUUUUUUUUUU
SSSUUUUOUUUUUUUUUUUU
UUUUUUUUUUUUUUUUUUUU
UUUUUUUUUUUOOUUUUUUU
UUUUUUUUUUUOOUUUUUUU
UUUUUUUUUUUOOUUUUUUU
UUUUUUUUUUUOOUUUOOOO
UUUOOOUUUUUOOUUUUUUU
UUUUUUUUUUUOOUUUUUUU
UUUUUUUUUUUUUUUUUUUU
UUUUUUUUUUUUUUUUUUUU
UUUUUUUUUUUUUUUUUEEE
UUUUUOUUUUUUUUOUUEEE
UUUUUOOUUUUUUUOUUEEE
