SSSUUUUUUOOOUUUUUUUU
SSSUUUUUUUUOUUUUUUUU
SSSUUUUUUUUOUUUUUUUU
UUUUUOUUUUUOUUUOOUUU
UUUUOOUUUUUUUUUUUUUU
UUUUUOUUUUUUUUUUUUUU
UUUUUOUUUUUUUUUUUUUU
UUUUUUUUUUUUUUUUUUOO
UUUUUUUUUUUUUUUUUUOO
UUUUUUUUUUUUUOOUUUUU
OOOUUUUUUUUUUUUUUUUU
OOOUUUUUUUOOUUUUUUUU
UUUUUUOUUUUUUUUUUEEE
UUUUUUOUUUUUUUUUUEEE
UUUUUUOUUUUUUUUUUEEE

